# 关卡1 - 交叉路径
# 玩家路径（蓝色）从(5,5)到(8,7）
# 敌方路径（绿色）从(9,5)到(8,7）

[Player]
5,5  # 起点
5,6  # 向下
5,7  # 向下
6,7  # 向右
7,7  # 向右
8,7  # 终点

[Enemy]
9,5  # 起点
8,5  # 向左
7,5  # 向左
7,6  # 向下
7,7  # 向下
8,7  # 终点